firstname	lastname	department
Peggie	MacGeffen	Legal
Katina	Ronci	Training
Anna-maria	Allmen	Legal
Deana	Fontes	Product Management
Winny	Bentson	Services
Mace	Bellard	Training
Ulrica	Gaythwaite	Product Management
Dillie	McGovern	Engineering
Ana	Bakeup	Marketing
Pepi	Hancill	Human Resources
Jacky	Maasz	Accounting
Oona	Gullen	Sales
Pippy	Millis	Support
Toby	Gagg	Product Management
Man	Perrycost	Services
Rodolphe	Wootton	Accounting
Marvin	Sidney	Legal
Beau	Kedslie	Support
Archaimbaud	Wayon	Training
Jakob	Meynell	Services
Tiena	Murrum	Engineering
Arther	Morrant	Legal
Lana	Deer	Human Resources
Wynne	Nevill	Research and Development
Benedicto	Hughf	Product Management
Urbanus	Nardoni	Engineering
Cybill	Mulbry	Support
Honey	Marlen	Human Resources
Claude	Brunn	Business Development
Symon	Wardingly	Research and Development
Glendon	Jakucewicz	Support
Lauren	Hollows	Support
Jamima	Wilshere	Support
Debor	Everett	Sales
Sutherland	Paulich	Business Development
Imojean	Gerhartz	Sales
Edita	Laurens	Services
Jason	Caesmans	Human Resources
Leeann	MacNeillie	Research and Development
Gwenni	Foyster	Support
Nata	Fargie	Product Management
Tierney	Dummigan	Services
Codie	Hinz	Human Resources
Jaymie	Bellon	Legal
Carla	Cruden	Engineering
Addy	Bodsworth	Sales
Gina	Kleinholz	Business Development
Mathian	Dabel	Product Management
Sadella	Kemmis	Legal
Zak	Adame	Support
Demetre	Laffoley-Lane	Marketing
Claiborne	Almeida	Sales
Alain	Ingerson	Services
Philippine	Grinyer	Accounting
Margaret	Shurrocks	Accounting
Gus	Gately	Support
Janek	Kornyakov	Business Development
Barbaraanne	Gallienne	Support
Kanya	Norway	Product Management
Madelin	Hugnet	Marketing
Margareta	Kenner	Product Management
Remington	McPeck	Human Resources
Ronni	Defries	Services
Tuesday	Baudoux	Engineering
Madelaine	Bartusek	Engineering
Juliane	Ganniclifft	Business Development
Myrna	Pidduck	Human Resources
Tull	Lovel	Legal
Jacynth	Sharnock	Training
Astra	Puller	Legal
Artair	Ruck	Services
Janot	Hardinge	Product Management
Mackenzie	Berrecloth	Accounting
Angelle	Thorald	Marketing
Jorrie	Ruppert	Sales
Kori	Hubbucke	Business Development
Tildy	Swanton	Services
Janifer	Birdsall	Research and Development
Fanya	Bresnahan	Services
Brenda	Aitken	Legal
Farrel	Habron	Human Resources
Farley	Pacey	Marketing
Sarina	Pagen	Sales
Emmery	Snoad	Product Management
Blinnie	Warriner	Research and Development
Lemar	Willard	Research and Development
Carena	Littlekit	Research and Development
Kathryn	Taks	Support
Galvin	Roncelli	Support
Ingeberg	Storrie	Accounting
Madonna	Fallens	Research and Development
Shannen	Matiewe	Product Management
Tobe	Stanion	Marketing
May	Hamber	Legal
Nickola	Wernham	Product Management
Cherianne	Luesley	Sales
Lucas	Baumer	Support
Bobina	Boult	Research and Development
Kermit	Gebuhr	Human Resources
Nonah	Lafoy	Engineering
Andrej	Beagrie	Services
Florella	Hollows	Human Resources
Beulah	Burley	Research and Development
Ralf	Chamberlaine	Sales
Terencio	Mullard	Legal
Rubie	Horrod	Research and Development
Stu	Prester	Business Development
Salomone	Coldman	Marketing
Cecilia	Scotsbrook	Marketing
Korey	Aire	Training
Darsey	Lettsom	Business Development
Luis	Kleinholz	Marketing
Ninette	Foyston	Support
Modesty	Goodband	Human Resources
Geordie	Kaygill	Business Development
Willy	Snalum	Engineering
Louie	Cushworth	Support
Freedman	Georghiou	Services
Caren	Sheering	Accounting
Tabby	Bloomfield	Training
Chanda	Dunk	Training
Antons	Seegar	Accounting
Emma	Scamaden	Services
Grantham	Jarratt	Services
Arvy	Chmiel	Marketing
Perry	Hawket	Product Management
Devin	Gathercoal	Product Management
Sonny	McNeil	Business Development
Clemens	Hartshorn	Engineering
Adella	Belham	Sales
Clywd	Sambrook	Legal
Mikaela	Clinkard	Business Development
Lorette	Henriksson	Sales
Dollie	Brammer	Legal
Junia	Vittery	Engineering
Othelia	Winkell	Product Management
Parker	Basham	Accounting
Livvyy	Andrag	Services
Caprice	Savil	Human Resources
Thor	Forsard	Human Resources
Tonia	Eliasen	Marketing
Avivah	Khoter	Sales
Cati	Cafferky	Marketing
Edy	Bundy	Human Resources
Kahaleel	Lambole	Human Resources
Eachelle	Ackroyd	Support
Philip	Arias	Training
Gwen	Burditt	Product Management
Cammi	Dorrington	Services
La verne	Wand	Sales
Dallon	Jamary	Legal
Eileen	Copland	Marketing
Chelsae	Bartke	Business Development
Tamiko	Flury	Product Management
Aveline	Clemmen	Engineering
Broddie	Alan	Training
Feliza	Ayllett	Support
Guillaume	Selwood	Business Development
Earle	Stenners	Services
Genevra	Edland	Engineering
Torrence	Solano	Support
Jorie	Heading	Research and Development
Gardner	Couzens	Legal
Charyl	Bockett	Accounting
Elsbeth	Edmands	Support
Barclay	Van Baaren	Accounting
Hamlen	Howey	Accounting
Riobard	Demageard	Legal
Minnnie	Raithbie	Legal
Laney	Braywood	Product Management
Jordain	Caslake	Services
Saidee	Froude	Support
Dag	Fransinelli	Sales
Matthew	Thurbon	Support
Demeter	Husselbee	Business Development
Nickie	Spickett	Sales
Kerry	Grimm	Legal
Cinderella	Gwillim	Legal
Caressa	Garfath	Human Resources
Berna	Luxen	Product Management
Peyton	Brearton	Sales
Kiele	Purry	Legal
Brucie	Sowray	Research and Development
Wheeler	Trumble	Legal
Jermain	Dechelette	Services
Evangelina	Cunnington	Services
Rafi	Bunten	Engineering
Jessica	Lyfield	Human Resources
Dare	Vlasov	Engineering
Portia	Hannigane	Accounting
Gaultiero	Cafe	Human Resources
Emera	Petersen	Legal
Gerladina	Feldharker	Product Management
Tamqrah	Nand	Marketing
Vernor	Skilbeck	Business Development
Allis	Greiser	Training
Gasper	Durdy	Services
Rubina	Durante	Support
Zerk	Costy	Legal
Derron	Blaszkiewicz	Product Management
Della	Hasell	Marketing
Savina	Dukelow	Legal
Rachel	Gawthrope	Business Development
Myrtie	Alekseicik	Sales
Rosana	Mollon	Support
Aida	Sellick	Support
Bartlet	Tregaskis	Support
Alden	Mathes	Training
Estell	Baff	Accounting
Ad	Elegood	Product Management
Clarice	Pavlenko	Marketing
Georgeanne	Dalgardno	Business Development
Adriane	Kener	Human Resources
Filberto	Filkov	Marketing
Ardelis	Ingleton	Research and Development
Thalia	Danby	Accounting
Annabal	Glasspool	Business Development
Colline	Wyke	Human Resources
Talia	Deftie	Product Management
Cynthie	Picford	Legal
Aeriela	Genn	Research and Development
Omero	Ivashev	Training
Fiorenze	Winfield	Research and Development
Debor	Leveret	Research and Development
Charline	Kopje	Business Development
Lenore	Fabri	Product Management
Josiah	Elwyn	Product Management
Braden	Wardel	Marketing
Inesita	Durante	Marketing
Edee	Jerger	Training
Cynthie	Bendare	Engineering
Melli	Webber	Legal
Ring	Trench	Accounting
Lawry	Feld	Accounting
Elana	Dorkins	Sales
Jesus	Alfonzo	Research and Development
Sandye	MacCaughen	Business Development
Melantha	Diggle	Accounting
Elfie	Logan	Sales
Eleanora	Wycherley	Business Development
Ilise	Sproul	Sales
Deirdre	Lettington	Support
Deny	Stroud	Accounting
Herminia	Wardingley	Sales
Shamus	Fridaye	Sales
Rozanna	Alaway	Services
Moore	Carle	Engineering
Harriott	Newport	Marketing
Vivienne	England	Engineering
Nancey	Reina	Product Management
Rees	Fisher	Sales
Rooney	Ellett	Legal
Raviv	Keyzor	Marketing
Anjanette	Fuchs	Engineering
Karissa	Oxbury	Business Development
Bobbie	Baiss	Training
Faustine	Pawfoot	Accounting
Tobi	Itscovitz	Business Development
Sena	Hanlon	Legal
Jessie	Molden	Training
Kareem	Chaplyn	Accounting
Orazio	Bondy	Human Resources
Ruth	Rosevear	Marketing
Gelya	Cothey	Research and Development
Augustin	Burwell	Research and Development
Burt	Northin	Legal
Jasen	Jeffries	Sales
Shoshana	Storah	Human Resources
Lucien	Janodet	Accounting
Collie	Eathorne	Business Development
Lucais	Lehrmann	Training
Zachery	Benardeau	Business Development
Genny	Vardie	Support
Vyky	Gabites	Business Development
Ramonda	Podbury	Legal
Virginia	Ricson	Engineering
Braden	Vasyutkin	Services
Cristian	Aberhart	Engineering
Crysta	Khoter	Engineering
Herold	Alstead	Human Resources
Ulric	Squires	Services
Kiah	Crighten	Human Resources
Carr	Bearn	Support
Hakim	Huffey	Support
Dana	Shotboulte	Business Development
Licha	Tweedell	Training
Benedikta	St. John	Legal
Charmian	Benes	Support
Teddy	Zima	Services
Viki	Lupton	Engineering
Giselle	Cassam	Business Development
Denise	Shera	Sales
Allyce	Sylett	Product Management
Willi	Burthom	Accounting
Skipton	Neath	Product Management
Gayelord	Gormley	Product Management
Flory	Audas	Product Management
Ferdinande	Odd	Research and Development
Roby	Stevings	Research and Development
Clerissa	Bleasdille	Product Management
Cherry	Radbone	Marketing
Bill	Fancott	Engineering
Gwenni	Cucinotta	Legal
Maynard	Kellington	Engineering
Allister	Sinnat	Accounting
Sibyl	Lightning	Support
Reinhold	Lovart	Human Resources
Doralynne	Sanches	Product Management
Rahal	Samme	Sales
Stefa	Lambard	Engineering
Sullivan	Stanbury	Services
Claire	Oaks	Business Development
Newton	Pitcock	Support
Gretel	Bewlay	Marketing
Petrina	Chatteris	Business Development
Dawn	Binge	Business Development
Daisey	Stoodale	Research and Development
Malinda	Oag	Research and Development
Nikaniki	Gregory	Product Management
Alfreda	Hollingsby	Product Management
Dotty	Olyfat	Accounting
Andie	McGookin	Training
Emmit	Leaver	Sales
Anderson	Pace	Human Resources
Kendell	Sauven	Human Resources
Dill	Corriea	Accounting
Janith	Thyer	Marketing
Nesta	Ganforth	Human Resources
Ellswerth	Sandcroft	Human Resources
Catlaina	Goggins	Sales
Christophorus	O'Dunneen	Accounting
Dell	Dammarell	Product Management
Gabriellia	Okey	Accounting
Fred	Judkin	Marketing
Faulkner	Treadaway	Human Resources
Lorraine	De Few	Research and Development
Tessy	Ravelus	Accounting
Syd	Caston	Product Management
Fidelity	Hickin	Business Development
Albina	Brunsdon	Sales
Nicolina	Easson	Engineering
Eva	Bevis	Research and Development
Linoel	Cleaton	Sales
Quinta	Bunyan	Accounting
Raymund	Quarles	Marketing
Harwell	Cleworth	Engineering
Corenda	Czadla	Marketing
Lavina	Sansum	Training
Davon	Olivelli	Services
Maryanne	Cassely	Support
Cara	Limb	Engineering
Skyler	Leatherborrow	Services
Iolanthe	Dimeloe	Legal
Cooper	Florez	Training
Inez	Coulling	Human Resources
Saleem	Goodbarne	Services
Sandie	Leheude	Marketing
Harp	Pumphreys	Engineering
Durand	Roughley	Product Management
Alfie	Jiroutka	Training
Ros	Garley	Product Management
Fancy	Rotge	Engineering
Zared	Guillond	Legal
Ebony	Macilhench	Human Resources
Demeter	Jedrychowski	Engineering
Odelinda	Strotone	Product Management
Robbyn	Marshallsay	Support
Vivianne	Rubinowitch	Accounting
Dasi	De Hailes	Training
Giulia	Minucci	Accounting
Ulla	Overel	Research and Development
Cullie	Drewe	Support
Meredithe	Sellwood	Research and Development
Hoyt	Waiton	Research and Development
Stefanie	McDermot	Research and Development
Towny	Scotchmer	Accounting
Rock	Roycroft	Sales
Jamesy	Korf	Engineering
Oliver	Brommage	Legal
Cayla	Roskam	Services
Zack	Taylor	Training
Paige	Wrightam	Human Resources
Krystyna	Edens	Sales
Niki	Kamenar	Services
Chantalle	Garfath	Services
Willdon	Littledike	Services
Dennie	Dabs	Product Management
Ulric	Caurah	Research and Development
Helyn	Welling	Business Development
Trev	Jedrzejewicz	Research and Development
Josie	Bernardotti	Legal
Pip	Vallentin	Engineering
Ber	Ragge	Accounting
Dylan	Nenci	Support
Christabella	Woodeson	Training
Adriaens	Falkner	Research and Development
Skelly	Rogez	Sales
Nels	Kilian	Business Development
Falito	Raine	Research and Development
Blake	MacGillivrie	Research and Development
Saudra	Leinster	Marketing
Dulciana	Beekman	Sales
Mable	Dunford	Support
Ophelia	Penvarne	Human Resources
Renelle	Avramovich	Marketing
Freddy	Marriott	Support
Carmelia	Spratt	Accounting
Peter	Faircliff	Marketing
Ulysses	Ourtic	Accounting
Vidovic	Manueli	Support
Winnifred	Lewerenz	Support
Bobette	Rose	Marketing
Merrie	Fullicks	Human Resources
Miriam	Prodrick	Human Resources
Cymbre	Allmond	Product Management
Pooh	Phythean	Training
Delainey	Peggram	Training
Tilly	Drayn	Legal
Laurice	Demicoli	Business Development
Arny	Clementi	Product Management
Cos	Tabbitt	Sales
Genevra	Gartan	Research and Development
Levon	Heinrici	Product Management
Yancy	Dounbare	Engineering
Hazlett	Varfalameev	Research and Development
Renato	O'Shee	Product Management
Clo	Palle	Marketing
Gavra	Andrich	Product Management
Lisha	Antushev	Business Development
Karen	Jantzen	Product Management
Blane	Tagg	Support
Sancho	Zottoli	Business Development
Gay	Jellyman	Training
Spence	Cressy	Research and Development
Thorpe	Bill	Services
Mord	Chase	Product Management
Pebrook	Timblett	Support
Hermie	Lemary	Business Development
Martguerita	Aspray	Accounting
Robers	Delph	Services
Candice	Fiennes	Business Development
Pauly	Bodycomb	Business Development
Alick	Van den Velde	Engineering
Patsy	Keeting	Legal
Nils	Wapol	Product Management
Twila	Killough	Engineering
Linnie	Weathers	Product Management
Micheal	Chatwin	Product Management
Jemima	Osgar	Marketing
Loreen	Chidler	Support
Omero	Collinson	Accounting
Sisely	Northin	Marketing
Tawsha	Fattore	Accounting
Ruttger	Sherland	Sales
Meredithe	Benduhn	Support
Nelia	Goodban	Marketing
Moritz	Rolance	Accounting
Oriana	Timothy	Business Development
Sancho	Walley	Human Resources
Cacilia	Romanin	Sales
Case	Pichmann	Marketing
Alejandra	Bilyard	Product Management
Ty	Kop	Legal
Haily	Daniau	Research and Development
Ninnette	Jeandin	Product Management
Juan	Muehler	Business Development
Dietrich	Fell	Support
Carolann	McGraw	Engineering
Bruno	Davion	Sales
Thatch	Ranklin	Product Management
Esmaria	Girardet	Legal
Analiese	Loveguard	Business Development
Yorke	Gresty	Sales
Terrill	Robertsson	Sales
Berny	Matuszyk	Marketing
Frayda	Chaplin	Business Development
Pascal	Fader	Sales
Conchita	Eddington	Legal
Seward	Eakins	Support
Abramo	Nesterov	Training
Ola	Connop	Training
Cris	Rentilll	Support
Davon	Forsdicke	Product Management
Maisie	McTague	Support
Edmund	Iacopetti	Sales
Marian	Ferriere	Training
Nye	Sturman	Services
Maura	Cribbin	Sales
Bennie	Templman	Marketing
Maiga	Scafe	Training
Leonardo	Winley	Training
Hatty	Benazet	Marketing
Jolene	Mereweather	Product Management
Hurley	Everall	Training
Anabal	Wildish	Support
Elysee	Alastair	Human Resources
Chelsey	Meysham	Business Development
Dorthea	Saylor	Research and Development
Ly	Pechan	Services
Mortimer	Lennon	Research and Development
Louisette	Suttaby	Sales
Hannie	Dewdney	Sales
Kizzee	Loughhead	Marketing
Tedmund	Sakins	Support
Ginelle	Kohrsen	Product Management
Aubrette	Lacase	Business Development
Erin	Antonsson	Sales
Bink	Pierson	Marketing
Brockie	O'Lenechan	Support
Emlynn	Angelo	Sales
Sibley	Najara	Legal
Moishe	Raitt	Research and Development
Maxy	Minard	Accounting
Rolando	Itscowics	Support
Vivianne	Rudland	Services
Ilysa	Chin	Marketing
Nikolos	Salterne	Human Resources
Steffen	Conant	Services
Robby	Spikings	Research and Development
Goldi	Tyght	Product Management
Ozzy	Brownbridge	Sales
Morgana	Welch	Services
Philippe	Dulton	Marketing
Israel	Giacobini	Training
Luella	Tranckle	Human Resources
Giulio	Edscer	Legal
Emelda	Fetherston	Research and Development
Adelaida	Fearnill	Human Resources
Avivah	Beevors	Accounting
Jessalin	Defries	Sales
Mandie	Inglesfield	Legal
Jonie	Gerauld	Product Management
Coralie	Jaggs	Product Management
Felicio	Spera	Legal
Yolane	Caldaro	Marketing
Leshia	Linster	Business Development
Shannon	Ram	Sales
Missy	Kettell	Engineering
Brinn	Jacquemy	Training
Lucilia	Cumming	Legal
Samantha	Adkins	Training
Peterus	Tregale	Engineering
Elyn	Breinlein	Business Development
Cecilia	Jesteco	Product Management
Andriana	Mitrovic	Product Management
Rycca	Joul	Services
Wilfrid	Cumberland	Sales
Hartwell	Dutch	Support
Miles	McAmish	Engineering
Binnie	Simonnot	Marketing
Gerti	Shills	Research and Development
Marianna	Westoll	Research and Development
Ceil	Beany	Business Development
Nathanil	Blackall	Engineering
Ruthe	Briance	Accounting
Aloise	Center	Business Development
Manya	Rickeard	Support
Calvin	Trippick	Legal
Sigfrid	McGee	Engineering
Clyve	Elkington	Business Development
Rowney	Burkman	Business Development
Mohandas	Luciani	Legal
Jaquith	Labusquiere	Product Management
Dulcia	Plewright	Marketing
Dennie	Feighry	Training
Shane	Nealand	Legal
Bevan	Defraine	Business Development
Persis	Maraga	Training
Jerri	Shilstone	Human Resources
Bertrando	Champain	Training
Martin	Burgh	Training
Even	Bradtke	Services
Trudy	Adenet	Product Management
Brittne	Robertsen	Support
Cissiee	Kelleher	Sales
Torrie	Gadie	Support
Lorain	Blaskett	Research and Development
Rois	Rosewell	Research and Development
Andreana	Zanre	Sales
Townsend	Meharry	Training
Hi	Allmark	Business Development
Tansy	Tourne	Research and Development
Dale	Crowley	Product Management
Didi	Whittaker	Business Development
Mercedes	Swinfen	Business Development
Ettie	Hebborne	Training
Moore	Smorthit	Training
Al	Rugieri	Research and Development
Goraud	Camilleri	Business Development
Nolana	Kidstoun	Training
Bridgette	Champness	Human Resources
Ellerey	Esley	Legal
Wolfy	Montgomery	Business Development
Aldwin	Dmisek	Legal
Rowena	Pavey	Accounting
Adelle	Woolham	Training
Reinaldos	Tomsett	Product Management
Merola	Vigors	Marketing
Valencia	Fulun	Engineering
Veriee	Freshwater	Engineering
Odette	Gatheridge	Legal
Rosabella	Dittson	Business Development
Margalit	Obern	Research and Development
Mohandis	Pashba	Engineering
Glennis	Ruddlesden	Support
Anthea	Tarplee	Training
Irita	Dadswell	Business Development
Heddie	Guiraud	Sales
Sayres	Antonellini	Product Management
Cedric	Avrahamof	Legal
Rozella	Clopton	Services
Chaddy	Tidbold	Sales
Westbrook	Morat	Product Management
Kayley	Raittie	Support
Sharai	Clyant	Services
Stacie	Caveill	Accounting
Daffy	Djuricic	Services
Bartolemo	Varvell	Product Management
Sapphire	Inkpin	Marketing
Sib	Van den Hof	Services
Johnnie	Stenton	Engineering
Jacintha	Kneller	Business Development
Morten	Daynter	Business Development
Hernando	Aizikov	Research and Development
Margie	Heard	Business Development
Evelyn	Smidmoor	Human Resources
Ladonna	Reinhart	Sales
Catina	Bugdell	Services
Talya	Dauby	Accounting
Merola	Steptowe	Business Development
Leora	Bodechon	Research and Development
Queenie	Johnys	Business Development
Calvin	Dorr	Engineering
Sibylla	Cleugh	Business Development
Reynold	Pietrowski	Business Development
Daphna	Ambrodi	Services
Delano	Darcy	Product Management
Page	Oglethorpe	Sales
Hynda	Yardley	Engineering
Ava	Albutt	Human Resources
Odille	Doige	Support
Rianon	Dalbey	Sales
Alexis	Comini	Human Resources
Raphael	Abbyss	Research and Development
Carver	Jodrellec	Services
Maria	O'Curneen	Support
Isa	Elsip	Product Management
Gilda	Keohane	Support
Eberto	Hales	Human Resources
Belinda	Gelder	Legal
Abbe	Grahlman	Research and Development
Corrie	Osgerby	Legal
Shepard	Beels	Accounting
Nikolaus	Spender	Engineering
Stevie	Hecks	Marketing
Melvin	Peaden	Human Resources
Beck	Hebbard	Support
Zelda	Allpress	Engineering
Ross	Pinkstone	Engineering
Keefe	Karpenko	Marketing
Dorie	Pavese	Human Resources
Hernando	Churchard	Engineering
Greg	Farlowe	Training
Jacob	Tuckwood	Training
Albie	Emanuelli	Sales
Franny	Vinden	Accounting
Emilia	Girk	Marketing
Dorian	Morsom	Business Development
Austen	Ringrose	Training
Reinold	Nendick	Training
Manolo	Jane	Research and Development
Zachariah	Pickthall	Legal
Daren	Gratland	Services
Devan	Harp	Product Management
Sergei	Ellph	Legal
Ema	Duplain	Support
Virge	Klaussen	Research and Development
Raymond	Pelosi	Legal
Maegan	Suatt	Support
Marilee	Patinkin	Legal
Wyatan	Gainseford	Research and Development
Rikki	Billanie	Support
Alfy	Roylance	Marketing
Gordan	Maddaford	Engineering
Yuri	Simms	Support
Sigfrid	Oscroft	Research and Development
Sarene	Fabri	Sales
Marshall	Snoad	Training
Tull	Renison	Human Resources
Burnaby	Edlington	Accounting
Sophie	Casburn	Training
Erminie	Eggleston	Research and Development
Humfrid	Schimank	Training
Edy	Stobo	Accounting
Julianne	Yard	Legal
Torre	Woolner	Legal
Ulrick	MacCambridge	Human Resources
Shelton	Baldocci	Accounting
Nataline	Durrand	Training
Bink	Jannings	Sales
Hilton	Maleck	Human Resources
Kassia	Chattelaine	Support
Bat	Guymer	Support
Carly	Chatteris	Sales
Barry	Canario	Legal
Lorianne	Battista	Business Development
Kristel	Degenhardt	Services
Karena	Boundley	Sales
Nert	Booler	Product Management
Desirae	Cranshaw	Research and Development
Egan	Ionesco	Services
Mavra	Tonner	Human Resources
Whitney	Fleury	Training
Hester	Stennett	Marketing
Barbaraanne	Borrie	Services
Cherish	Collinwood	Product Management
Nicolle	Habergham	Engineering
Penelopa	Matantsev	Human Resources
Kirby	Gittings	Business Development
Dyna	Crecy	Accounting
Alfonso	Holdey	Accounting
Tanner	Alen	Legal
Mervin	Stephens	Services
Ramona	Seegar	Services
Emlen	Reek	Services
Mandi	Prestner	Business Development
Pammy	Douthwaite	Sales
Ranique	Valler	Research and Development
Thea	Brelsford	Product Management
Bernice	Le Blond	Legal
Sloane	Gierth	Sales
Gaspard	Jansema	Sales
Harlin	Graith	Engineering
Bendicty	Beininck	Human Resources
Becca	Bomb	Accounting
Cristobal	Oldis	Research and Development
Haskel	Shorie	Marketing
Rudyard	Petrolli	Research and Development
Adaline	Swanborough	Research and Development
Floyd	Grigoryov	Product Management
Ninette	Kulis	Research and Development
Emlyn	Marsden	Engineering
Odey	Woodwin	Engineering
Laetitia	Cunrado	Engineering
Nollie	McInally	Business Development
Moina	Houdhury	Marketing
Corby	Siddell	Research and Development
Blaire	Matfield	Engineering
David	Christopher	Accounting
Charlot	Press	Research and Development
Coretta	Sorro	Training
Addi	Veldstra	Support
Janith	Rouch	Legal
Sam	Branch	Accounting
Ginger	Sanders	Training
Rozanne	Penni	Training
Ermina	Phelipeau	Business Development
Kaye	Guiet	Marketing
Laural	Hawkin	Sales
Del	Hellin	Legal
Caspar	Budd	Services
Augustine	Kenen	Sales
Neil	De Marchi	Product Management
Betti	Rothman	Human Resources
Erik	Wedge	Training
Garland	Axon	Training
Harcourt	Roberts	Business Development
Raina	Doe	Human Resources
Caralie	Stawell	Business Development
Alane	Dredge	Services
Rickert	Prue	Legal
Augustine	Crottagh	Marketing
Frederick	Tomczykowski	Marketing
Janey	Borrowman	Business Development
Philipa	Skellorne	Accounting
Ingmar	Fanti	Sales
Patty	Keats	Human Resources
Marcia	Jansen	Legal
Clerkclaude	Toor	Engineering
Rosita	Brunesco	Sales
Thomasina	Rhydderch	Accounting
Lewiss	Passman	Marketing
Arluene	Keveren	Support
Leontyne	Paolini	Services
Imogene	Storrock	Support
Alon	Biner	Research and Development
Burnaby	Ambrogelli	Accounting
Beverly	Anfosso	Sales
Xerxes	Drabble	Services
Janella	Chalk	Business Development
Brennan	Rustedge	Services
Andrea	Addess	Accounting
Mellisent	Lardnar	Marketing
Alana	Treadgear	Product Management
Wainwright	Londesborough	Research and Development
Domenico	Overpool	Business Development
Alexei	Huonic	Legal
Jessi	Nowaczyk	Support
Tressa	Thrift	Business Development
Brent	Quarrington	Business Development
Sheeree	Ruthen	Engineering
Bronny	Ritelli	Support
Lanna	Andrewartha	Research and Development
Corty	Gutman	Services
Worden	Lenton	Research and Development
Adams	Bunten	Accounting
Garrett	Madeley	Sales
Boonie	Tullett	Sales
Lorrin	Gabb	Engineering
Brose	Salatino	Services
Cathie	Goldingay	Engineering
Hobart	Groome	Training
Revkah	Selland	Legal
Timotheus	Halstead	Services
Nicolai	Swadling	Research and Development
Alexine	Tonn	Product Management
Antin	Wycliff	Services
Ali	Roj	Product Management
Lorin	Tregidgo	Sales
Linnea	Camilli	Human Resources
Ola	O'Brien	Services
Mirella	Rawlingson	Services
Milli	Hounsom	Legal
Damara	Rosendahl	Research and Development
Kit	Chatterton	Sales
Allene	Plimmer	Support
Gale	Pennacci	Support
Hildagarde	Dowell	Sales
Leigh	Lewins	Accounting
Stearn	McAnellye	Human Resources
Stephine	Rapin	Support
Rebe	Chopy	Support
Simon	Javes	Business Development
Stephie	Sorensen	Research and Development
Myrta	Petrello	Research and Development
Elwira	Everist	Training
Stevie	Hamper	Accounting
Skip	Roj	Support
Brennen	Sire	Services
Hermione	Huckin	Sales
Trumann	Ebbitt	Engineering
Esmaria	Bourdice	Support
Judd	Dainty	Research and Development
Nettle	Bailes	Marketing
Filberto	Morgans	Support
Bale	Drinkhill	Services
Artemas	Schustl	Training
Humbert	Dark	Business Development
Hailey	Chillingsworth	Marketing
Lucy	Nowaczyk	Human Resources
Eli	Landy	Services
Obie	Cubbit	Product Management
Fonzie	Pickhaver	Human Resources
Jasen	Morit	Training
Fredia	Kubica	Accounting
Justin	Dolling	Engineering
Reeta	Patillo	Human Resources
Krystyna	Paike	Marketing
Betti	Lawrenz	Legal
Yurik	Tock	Business Development
Sharity	Sperrett	Accounting
Dougy	Whitta	Support
Meg	Mytton	Sales
Chester	Inkin	Human Resources
Annabella	Capelle	Sales
Feodor	Gange	Legal
Ashlan	Vivyan	Marketing
Felice	Aggett	Services
Jeremie	Broadnicke	Support
Zerk	Dionisi	Accounting
Greer	Von Der Empten	Support
Guy	Ilyushkin	Research and Development
Hyacinthe	Hise	Services
Homerus	Bergeon	Business Development
Fernanda	Dobinson	Product Management
Kirsteni	Pattemore	Training
Zara	Gimson	Legal
Nikoletta	Treske	Sales
Lauralee	Snoxill	Support
Kyla	Lideard	Training
Marcela	Bodicum	Research and Development
Alvis	Few	Research and Development
Ortensia	Labet	Marketing
Mick	Cassley	Accounting
Forster	Patrone	Support
Lexy	Canepe	Accounting
Sadie	Paddie	Services
Constantin	Livezley	Product Management
Kirstin	Greep	Support
Ethe	Tamsett	Accounting
Vincenty	Bare	Marketing
Maude	Matzkaitis	Sales
Ralph	Seabrook	Business Development
Nina	Smiths	Engineering
Elliot	Fabri	Product Management
Nerita	Lefridge	Sales
Lilah	Kisting	Human Resources
Ellis	Bodycomb	Human Resources
Rey	Oloshin	Legal
Bryant	Casperri	Business Development
Say	Keneleyside	Marketing
Lorelei	Campkin	Human Resources
Yvette	Basini-Gazzi	Product Management
Zandra	Mitkov	Legal
Jessamyn	Bunnell	Business Development
Zena	Bridgement	Accounting
Dew	Morde	Engineering
Pearl	Lakey	Support
Dacia	Ablewhite	Services
Melitta	Paule	Marketing
Aundrea	Haire	Services
Hakim	Connell	Training
Emelita	Hawkes	Training
Derrik	Mitchinson	Sales
Nikolaus	Cradick	Support
Mart	Critoph	Services
Bronnie	Simonetti	Research and Development
Tiebold	Morcomb	Sales
Glennie	Hutt	Accounting
Tiphani	Guyonneau	Sales
Vance	Firk	Services
Nananne	Skiggs	Product Management
Stewart	Jarville	Human Resources
Becka	Feldman	Training
Jerrilee	Mathet	Legal
Jonell	Yewen	Training
Jenica	O' Quirk	Sales
Aldis	Hollidge	Engineering
Rob	Sauvage	Human Resources
Dorian	Jurasek	Research and Development
Etty	Dencs	Sales
Reinaldos	Blackaller	Human Resources
Maggee	Diem	Accounting
Isabella	Scrowston	Research and Development
Eda	Lightollers	Legal
Zollie	Hillum	Research and Development
Christiano	Heggman	Research and Development
Jobie	Murty	Product Management
Etienne	Fitzroy	Product Management
Jilleen	Pitkeathly	Research and Development
North	Branson	Training
Ward	Kirkup	Business Development
Loleta	Harnetty	Engineering
Consolata	Tonge	Human Resources
Vyky	Tregenza	Human Resources
Conan	Lilford	Training
Gayle	Franies	Marketing
Angelika	Boggers	Product Management
Clay	Twyning	Research and Development
Merry	Habble	Training
Ardelle	Scrace	Product Management
Tedda	Zimmermanns	Research and Development
Pam	Gilvear	Research and Development
Jean	Rowena	Training
Jaclin	Coston	Engineering
Judi	Ruzek	Human Resources
Peggie	Btham	Research and Development
Waverly	Fourmy	Product Management
Christiano	Gamon	Human Resources
Waylan	Scholes	Product Management
Wendi	Folcarelli	Product Management
Bartlet	Denmead	Sales
Lawry	Berzin	Support
Merridie	Forge	Support
Lillian	Purtell	Sales
Georgia	Brogioni	Research and Development
Godard	Elderton	Training
Gertrud	Ashfold	Engineering
Thorstein	Liepins	Business Development
Jeffry	Woodley	Research and Development
Dahlia	Laurenty	Research and Development
Sharai	Fairlem	Support
Mozelle	Watkins	Marketing
Zsa zsa	Dagon	Product Management
Lian	Fraczak	Human Resources
Alejoa	Arzu	Human Resources
Rhetta	McKeller	Research and Development
Elora	Jeannenet	Business Development
Janaya	Cordy	Accounting
Lutero	Grenshiels	Support
Galina	Comer	Business Development
Aluino	Ellen	Legal
Liza	Rau	Product Management
Evangelina	Espadero	Business Development
Dyanna	Zamora	Support
Prentice	Nottingham	Sales
Merle	Wollaston	Legal
Aveline	Knatt	Marketing
Tonie	Goodacre	Sales
Mechelle	Calladine	Engineering
Arlena	Mapplethorpe	Human Resources
Myer	Maycey	Marketing
Kevon	Cammis	Human Resources
Jeromy	Croke	Training
Bryana	Edy	Sales
Chrissie	Milsom	Marketing
Loralee	Edwick	Business Development
Kennie	Beneyto	Sales
Sigismond	Henkmann	Research and Development
Thelma	Oulet	Services
